#######
#@....#
#.#.#.#
#.#E#.#
#.....#
#######
